111111111111111111111111111111111
110011111111100011000000011111001
100111111111000111001000011110011
110011111110001111011000011111001
100111111100011111111000111110011
110011111000111111110001111111001
100111110001111111100011111110011
1100111100000000010C0111111111001
100111100000000001110110011110011
11001111000000C00000P100011111001
100111111111110001111111111110011
11001111111111E101111111111111001
10011111111111C101111111111110011
111111111111111111111111111111111